{
  "id": 1,
  "name": "Level 1",
  "difficulty": 1,
  "rows": 15,
  "cols": 15,
  "tileSize": 35,
  "start": { "x": 1, "y": 1 },
  "grid": [
    [1,1,1,1,1,1,1,1,1,1,1,1,1,1,1],
    [1,0,3,0,1,0,3,0,0,0,1,0,0,0,1],
    [1,3,1,0,1,0,1,1,1,0,1,0,1,0,1],
    [1,0,1,3,0,0,0,0,1,0,0,0,1,0,1],
    [1,0,1,1,1,1,1,0,1,1,1,1,1,0,1],
    [1,0,0,0,0,0,1,0,0,0,3,0,1,0,1],
    [1,1,1,3,1,0,1,1,1,0,1,3,1,0,1],
    [1,0,0,0,1,0,0,0,1,0,1,0,0,0,1],
    [1,0,1,0,0,3,1,0,1,0,1,0,1,1,1],
    [1,0,1,1,1,0,1,0,0,0,1,0,0,0,1],
    [1,0,0,0,1,0,0,3,1,1,1,1,1,0,1],
    [1,1,1,0,1,1,1,0,1,0,3,0,0,3,1],
    [1,0,0,0,0,0,1,0,0,0,1,1,1,0,1],
    [1,0,1,1,1,3,1,1,1,0,3,0,0,0,1],
    [1,1,1,1,1,1,1,1,1,1,1,1,1,2,1]
  ]
}