{
  "id": 3,
  "name": "Level 3",
  "rows": 19,
  "cols": 19,
  "tileSize": 30,
  "difficulty": 3,
  "start": { "x": 1, "y": 1 },
  "grid": [
    [1,1,1,1,1,1,1,1,1,1,1,1,1,1,1,1,1,1,1],
    [1,0,0,0,1,0,0,0,1,0,0,0,1,0,0,0,0,0,1],
    [1,0,1,0,1,0,1,0,1,0,1,0,1,0,1,1,1,0,1],
    [1,3,1,0,0,0,1,3,0,0,1,0,0,0,1,0,3,0,1],
    [1,0,1,1,1,1,1,0,1,1,1,0,1,1,1,0,1,0,1],
    [1,0,0,0,0,0,1,0,0,0,1,0,0,0,0,0,1,0,1],
    [1,1,1,3,1,0,1,1,1,0,1,1,1,3,1,1,1,0,1],
    [1,0,0,0,1,0,0,0,0,0,1,0,0,0,1,0,0,0,1],
    [1,0,1,0,0,3,1,0,1,1,1,0,1,0,0,3,1,0,1],
    [1,0,1,1,1,0,1,0,0,0,0,0,1,1,1,0,1,0,1],
    [1,0,0,0,1,0,0,0,1,3,1,0,0,0,1,0,0,0,1],
    [1,1,1,0,1,1,1,0,1,0,1,1,1,0,1,1,1,3,1],
    [1,0,0,0,0,0,1,0,0,0,1,0,0,0,0,0,1,0,1],
    [1,0,1,1,1,3,1,1,1,0,1,0,1,1,1,3,1,0,1],
    [1,0,1,0,0,0,0,0,1,0,0,0,1,0,0,0,0,0,1],
    [1,3,1,0,1,1,1,0,1,1,1,0,1,0,1,1,1,0,1],
    [1,0,0,0,1,0,3,0,0,0,1,0,0,0,1,0,3,0,1],
    [1,0,1,1,1,0,1,1,1,3,0,0,1,0,0,0,1,0,1],
    [1,1,1,1,1,1,1,1,1,1,1,1,1,1,1,1,1,2,1]
  ]
}